{
    "0": 2,
    "76": 23,
    "77": 23,
    "79": 23,
    "181": 13,
    "468": 43,
    "10": 23,
    "342": 30,
    "295": 27,
    "316": 27,
    "317": 27,
    "262": 22,
    "263": 22,
    "264": 22,
    "265": 22,
    "266": 22,
    "211": 17,
    "212": 17,
    "213": 17,
    "214": 17,
    "215": 17,
    "216": 17,
    "201": 15,
    "202": 15,
    "203": 15,
    "204": 15,
    "205": 15,
    "206": 15,
    "207": 15,
    "208": 15,
    "188": 13,
    "189": 13,
    "190": 13,
    "191": 13,
    "192": 13,
    "170": 10,
    "157": 8,
    "158": 8,
    "159": 8,
    "160": 8,
    "81": 2,
    "82": 2,
    "83": 2,
    "84": 2,
    "85": 2,
    "86": 2,
    "90": 2,
    "91": 2
}